111111111111111111111111111
1000100C0000000000100000E01
1C1000C10000000100001110001
110001C10000010000000011001
100000110000111111111111111
10000000C00C01C1100C11100C1
10111C0000C0010000111C0C111
11000000001C000111100000001
100C111000CC100000000100001
10111000000001C000000C11001
11C0000C0000111000000000001
100000100010000000000000001
10000000000000C000000000001
1000P0000010000000000000001
111111111111111111111111111